3 1 6 5 6 5 0 5
1 0 5 4 3 3 7 5
4 5 2 1 5 6 7 1
6 3 0 6 4 1 0 3
4 5 4 2 0 0 2 0
3 1 3 1 5 7 2 2
2 6 6 3 2 4 4 6
1 7 0 7 4 4 4 4
